{
  "size": "8,8",
  "map": [
    [0, 0, 1, 1, 1, 0, 0, 0],
    [0, 0, 1, 2, 1, 0, 0, 0],
    [0, 0, 1, 2, 1, 1, 1, 1],
    [1, 1, 1, 2, 2, 2, 2, 1],
    [1, 2, 2, 2, 2, 1, 1, 1],
    [1, 1, 1, 1, 2, 1, 0, 0],
    [0, 0, 0, 1, 2, 1, 0, 0],
    [0, 0, 0, 1, 1, 1, 0, 0]
  ],
  "hero": "4,4",
  "box": [
    "3,3", "5,3", "3,4", "4,5"
  ],
  "dst": [
    "3,1", "4,6", "6,3", "1,4"
  ]
}
